305 305 305 305 305 305 305 305 305 305 305 305 305 305 305 305 305 305 305 305 305 305 305 305 305 305 305 305 305 305 305 305 305 305 305 305 305 305 305 305 305 305 305 305 305 305 305 305 305 305 305 305 305 305 305 305 305 305 305 305 305 305 305 305 305 305 305 305 305 305 305 305 305 305 305 305 305 305 305 305 305 305 305 305 305 305 305 305 305 305 305 305 305 305 305 305 305 305 305 305 305 305 305 305 305 305 305 305 305 305 305 305 305 305 305 305 305 305 305 305 305 305 305 305 305 305 305 305 305 305 
305 22 36 36 36 36 36 36 36 36 36 37 321 321 321 321 321 321 321 321 321 321 321 321 321 321 321 321 321 321 321 321 321 321 321 321 321 321 321 321 321 321 321 321 321 321 321 321 321 321 321 321 321 321 321 321 321 321 321 321 321 321 321 321 21 22 36 36 36 36 36 36 36 36 36 36 36 36 36 36 22 23 137 136 137 136 137 136 137 136 137 136 137 136 137 136 137 136 137 136 137 136 137 136 137 136 137 136 137 136 137 136 137 290 291 292 137 136 137 290 291 292 137 136 137 136 137 136 21 305 
305 23 12 13 10 11 12 13 10 11 321 321 321 321 321 321 321 321 321 321 321 321 321 321 321 321 321 321 321 321 321 321 321 321 321 321 321 321 321 321 321 321 321 321 321 321 321 321 321 321 321 321 321 321 321 321 321 321 321 321 321 321 321 321 21 23 123 122 123 122 123 122 123 122 123 122 123 122 123 122 21 23 123 122 123 122 123 122 123 122 123 122 123 122 123 122 123 122 123 122 123 122 123 122 123 122 123 122 123 122 123 122 123 290 291 292 123 122 123 290 291 292 123 122 123 122 123 122 21 305 
305 23 40 41 38 39 40 41 38 39 321 321 321 321 321 321 321 321 321 321 321 321 321 321 321 321 321 321 321 321 321 321 321 321 321 321 321 321 321 321 321 321 321 321 321 321 321 321 321 321 321 321 321 321 321 321 321 321 321 321 321 321 321 321 21 23 137 136 137 136 137 136 137 136 137 136 137 136 137 136 21 23 137 136 137 136 137 136 137 136 137 136 137 136 137 136 137 136 137 136 137 136 137 136 137 136 137 136 137 136 137 136 137 290 291 292 137 136 137 290 291 292 137 136 137 136 137 136 21 305 
305 23 24 25 26 27 24 25 26 27 321 321 321 321 321 321 321 321 321 321 321 321 321 321 321 321 321 321 321 321 321 321 321 321 321 321 321 321 321 321 321 321 321 321 321 321 321 321 321 321 321 321 321 321 321 321 321 321 321 321 321 321 321 321 21 23 123 122 123 122 123 122 123 122 123 122 123 122 123 122 21 23 123 122 123 122 123 122 123 122 123 122 123 122 123 122 123 122 123 122 123 122 123 122 123 122 123 122 123 122 123 122 123 290 291 292 123 122 123 290 291 292 123 122 123 122 123 122 21 305 
305 23 38 39 40 41 38 39 40 41 321 321 321 321 321 321 321 321 321 321 321 321 321 321 321 321 321 321 321 321 321 321 321 321 321 321 321 321 321 321 321 321 321 321 321 321 321 321 321 321 321 321 321 321 321 321 321 321 321 321 321 321 321 321 21 23 137 136 137 136 137 136 137 136 137 136 137 136 137 136 21 23 137 136 137 136 137 136 137 136 137 136 137 136 137 136 137 136 137 136 137 136 137 136 137 136 137 136 137 136 137 136 137 290 263 292 137 136 137 290 263 292 137 136 137 136 52 53 21 305 
305 23 26 27 24 25 26 27 24 25 321 321 321 321 321 321 321 321 321 321 92 93 321 321 92 93 321 321 321 321 92 93 321 321 321 321 321 321 321 321 321 321 321 321 321 321 321 321 321 321 321 321 321 321 321 321 321 321 321 321 321 321 321 321 21 23 123 122 123 122 123 122 123 122 123 122 123 122 123 122 21 23 123 122 123 122 123 122 123 122 123 122 123 122 123 122 123 122 123 122 123 122 123 122 123 122 123 290 291 292 123 122 123 276 277 278 162 163 163 276 277 278 123 122 123 122 66 67 21 305 
305 23 40 41 38 39 40 41 38 39 321 321 321 321 321 321 321 321 321 321 321 321 321 321 321 321 321 321 321 321 321 321 321 321 321 321 51 321 321 321 321 321 321 321 321 321 321 321 321 321 321 321 321 321 321 321 321 321 321 321 321 321 321 321 21 23 137 136 137 136 137 136 137 136 137 136 137 136 137 136 21 23 137 136 137 136 137 136 137 136 137 136 137 136 137 136 137 136 137 136 137 136 137 136 137 136 137 160 305 161 137 136 137 290 291 292 176 177 177 290 291 292 137 136 137 136 54 55 21 305 
305 23 24 25 7 63 63 9 26 27 321 321 321 92 93 321 321 321 321 321 321 321 321 321 321 321 321 321 321 321 321 321 321 321 321 321 321 321 321 321 321 321 321 321 321 321 321 321 321 321 321 321 321 321 321 321 321 321 321 321 321 321 321 321 21 23 123 122 123 122 123 122 123 122 123 122 123 122 123 122 35 37 123 122 123 122 123 122 123 122 123 122 123 122 123 122 123 122 123 122 123 122 123 122 123 122 123 290 291 292 162 163 163 290 291 292 176 177 177 290 291 292 162 163 163 163 68 69 21 305 
305 23 38 39 21 22 22 23 40 41 321 321 321 321 321 321 321 321 321 321 321 321 321 321 321 321 321 321 321 321 321 321 321 321 321 321 321 321 321 321 321 321 321 321 321 321 321 321 321 321 321 321 321 321 321 321 321 321 321 321 321 321 321 321 21 23 137 136 119 120 120 121 137 136 137 136 137 136 137 136 137 136 137 136 137 136 137 136 137 136 137 136 137 192 137 136 193 136 137 192 137 136 193 136 137 136 137 290 291 292 176 177 177 290 291 292 176 177 177 290 291 292 176 177 49 82 82 82 22 305 
305 62 63 63 64 22 22 62 63 63 63 9 321 321 321 321 321 321 321 321 321 321 321 321 321 321 321 321 321 321 321 321 321 321 321 321 321 321 321 51 321 321 321 321 49 50 321 321 321 51 321 321 321 51 321 321 321 51 321 321 321 321 321 321 21 23 123 122 81 82 82 83 123 122 123 122 123 122 123 122 123 122 123 122 123 178 179 122 123 178 179 122 123 65 123 122 65 122 123 65 123 122 65 122 123 122 123 290 291 292 176 177 177 290 291 292 176 177 177 290 291 292 176 177 305 305 126 128 21 305 
305 22 36 36 36 36 36 36 36 36 36 37 321 321 321 321 321 321 321 321 321 321 321 321 321 321 321 321 321 321 321 321 321 321 321 321 321 321 321 321 321 321 321 321 321 321 321 321 321 321 321 321 321 321 321 321 321 321 321 321 321 321 321 321 21 23 137 136 21 22 22 23 137 136 119 120 120 120 120 120 120 120 121 136 137 54 55 136 137 52 53 136 137 233 137 136 234 136 137 233 137 136 234 136 137 119 120 120 120 120 120 120 120 120 120 120 120 120 120 120 120 120 120 120 120 120 121 127 21 305 
305 23 321 321 321 321 321 321 321 321 321 321 321 321 321 321 321 321 321 321 321 321 321 321 321 321 321 321 321 321 321 321 321 321 321 321 321 321 321 321 321 321 321 321 321 321 321 321 321 321 321 321 321 321 321 321 321 321 321 321 49 50 321 321 21 23 248 247 21 22 22 23 248 247 81 82 82 82 82 82 82 82 83 247 248 68 69 247 248 66 67 247 248 247 248 247 248 247 248 247 248 247 248 247 248 81 82 82 82 82 82 82 82 82 82 82 82 82 82 82 82 82 82 82 82 82 83 127 21 305 
305 23 321 321 321 321 321 321 321 321 321 321 321 321 321 321 321 321 321 321 321 321 321 321 321 321 321 321 321 321 321 321 321 321 321 321 321 321 321 321 321 321 321 321 321 321 321 321 321 321 321 321 321 321 321 321 321 321 321 321 321 321 321 321 21 305 305 305 305 305 305 305 305 305 305 305 305 305 305 305 305 305 305 305 305 305 305 305 305 305 305 305 305 305 305 305 305 305 305 305 305 305 305 305 305 305 305 305 305 305 305 305 305 312 99 99 99 99 99 99 99 99 99 99 99 311 86 127 84 305 
305 23 321 321 321 321 321 321 321 321 321 321 321 321 321 321 321 321 321 321 321 321 321 321 321 321 321 321 321 321 321 321 321 321 321 321 321 321 321 321 321 321 321 321 321 321 321 321 321 321 321 321 321 321 321 321 321 321 321 321 321 321 321 321 21 305 305 305 305 305 305 305 305 305 305 305 305 305 305 305 305 305 305 305 305 305 305 305 305 305 305 305 305 305 305 305 305 305 305 305 305 305 305 305 305 305 305 305 305 305 305 305 305 86 305 305 305 305 305 305 305 173 305 305 305 84 86 127 84 305 
305 23 321 321 321 321 321 321 321 321 321 321 321 321 321 26 27 24 25 26 27 321 321 26 27 24 25 26 27 321 321 321 321 321 321 321 321 321 321 321 321 321 321 321 321 321 321 321 321 321 321 321 321 321 321 321 321 321 321 321 321 321 321 321 21 305 305 305 305 305 305 305 305 305 305 305 305 305 305 305 305 305 305 305 305 305 305 305 305 305 305 305 305 305 305 305 305 305 305 305 305 305 305 305 305 305 305 305 305 305 305 305 305 86 305 305 305 305 305 305 305 187 305 305 305 84 86 127 84 305 
305 23 321 321 321 321 321 321 321 321 321 321 321 321 321 40 41 38 39 40 41 321 321 40 41 38 39 40 41 321 321 321 321 321 321 321 321 321 321 321 321 321 321 321 321 321 321 321 321 321 321 321 321 321 321 321 321 321 321 321 321 321 321 49 22 305 305 305 305 305 305 305 305 305 305 305 305 305 305 305 305 305 305 305 305 305 305 305 305 305 305 305 305 305 305 305 305 305 305 305 305 305 305 305 305 305 305 305 305 305 305 305 305 86 305 168 169 305 305 87 105 105 91 305 305 98 100 127 84 305 
305 23 321 321 321 321 321 321 321 321 321 321 321 321 321 24 25 26 27 24 25 321 321 24 25 26 27 24 25 321 321 321 321 321 321 321 321 321 321 321 321 321 321 321 321 321 0 5 6 321 321 321 321 321 321 321 321 321 25 26 27 24 25 12 21 305 305 305 305 305 305 305 305 305 305 305 305 305 305 305 305 305 305 305 305 305 305 305 305 305 305 305 305 305 305 305 305 305 305 305 305 305 305 305 305 305 305 305 305 305 305 305 305 86 315 182 183 305 87 88 85 85 90 91 305 305 305 305 84 305 
305 23 321 321 321 321 321 321 321 321 321 321 321 321 321 38 39 51 143 143 51 321 321 51 155 155 51 38 39 321 321 321 321 321 321 321 321 321 0 1 2 3 4 28 19 18 20 19 20 19 20 19 20 16 20 16 17 20 39 40 41 38 39 40 21 305 305 305 305 305 305 305 305 305 305 305 305 305 305 305 305 305 305 305 305 305 305 305 305 305 305 305 305 305 305 305 305 305 305 305 305 305 305 305 305 305 305 305 305 305 305 305 305 86 169 315 305 305 314 99 99 99 311 90 105 105 105 105 106 305 
305 23 321 321 321 5 6 321 321 321 321 321 321 321 321 26 27 10 11 12 13 4 321 12 13 10 11 26 27 0 28 14 15 20 19 31 18 20 19 20 19 31 42 43 43 43 43 43 43 43 43 29 30 44 32 33 7 9 27 24 25 26 27 24 21 305 305 305 305 305 305 305 305 305 305 305 305 305 305 305 305 305 305 305 305 305 305 305 305 305 305 305 305 305 305 305 305 305 305 305 305 305 305 305 305 305 305 305 305 305 305 305 305 86 183 305 305 305 173 174 174 174 98 99 99 99 99 99 311 305 
305 23 19 20 19 20 19 20 31 20 19 16 17 18 19 40 41 38 39 40 41 20 18 40 41 38 39 51 41 42 43 43 43 29 30 44 32 43 43 29 30 44 32 33 34 43 43 43 29 47 48 44 44 44 44 48 21 23 41 38 7 63 63 63 64 305 305 305 305 305 305 305 305 305 305 305 305 305 305 305 305 305 305 305 305 305 305 305 305 305 305 305 305 305 305 305 305 305 305 305 305 305 305 305 305 305 305 305 305 305 305 305 305 104 105 105 72 305 187 203 203 203 174 175 305 305 305 305 84 305
305 23 43 43 33 34 29 30 44 32 43 43 43 43 43 24 25 26 27 7 63 63 63 63 9 26 27 10 25 43 43 29 48 44 44 44 44 48 47 44 44 44 44 48 48 46 48 47 44 44 44 44 44 318 58 63 64 23 25 26 35 36 36 36 22 305 305 305 305 305 305 305 305 305 305 305 305 305 305 305 305 305 305 305 305 305 305 305 305 305 305 305 305 305 305 305 305 305 305 305 305 305 305 305 305 305 305 305 305 305 305 305 305 85 85 85 86 305 102 203 203 203 203 204 305 305 305 305 84 305
305 23 48 46 48 46 44 44 44 44 48 47 48 48 7 9 39 40 41 21 22 22 22 22 23 40 41 38 39 47 46 318 58 63 63 61 320 44 44 318 58 63 63 61 320 44 44 44 44 44 44 318 57 317 22 22 22 23 39 40 305 305 126 128 21 305 305 305 305 305 305 305 305 305 305 305 305 305 305 305 305 305 305 305 305 305 305 305 305 305 305 305 305 305 305 305 305 305 305 305 305 305 305 305 305 305 305 305 305 305 305 305 305 312 99 99 100 305 173 203 203 203 203 204 305 305 305 305 84 305
305 62 63 63 63 63 63 63 63 63 63 63 63 63 64 62 63 63 63 64 22 22 22 22 62 9 155 155 155 155 7 317 22 22 22 22 316 63 63 317 22 22 22 22 316 9 155 155 155 155 7 317 22 22 22 22 22 62 63 63 63 63 9 127 21 305 305 305 305 305 305 305 305 305 305 305 305 305 305 305 305 305 305 305 305 305 305 305 305 305 305 305 305 305 305 305 305 305 305 305 305 305 305 305 305 305 305 305 305 305 305 305 305 86 129 126 305 305 187 203 102 203 203 102 305 305 103 135 84 305
305 22 22 22 22 22 22 22 22 22 22 22 22 22 22 22 22 22 22 22 22 22 22 22 22 22 82 82 82 82 22 22 22 22 22 22 22 22 22 22 22 22 22 22 22 22 82 82 82 82 22 22 22 22 22 22 22 22 22 22 22 22 23 127 21 305 305 305 305 305 305 305 305 305 305 305 305 305 305 305 305 305 305 305 305 305 305 305 305 305 305 305 305 305 305 305 305 305 305 305 305 305 305 305 305 305 305 305 305 305 305 305 305 86 127 70 71 72 187 203 174 203 203 175 305 305 313 149 84 305
305 305 305 305 305 305 305 305 305 305 305 305 305 305 305 305 305 305 305 305 305 305 305 305 305 305 305 305 305 305 305 305 305 85 85 85 85 85 85 85 85 85 85 85 85 85 85 85 85 85 85 85 85 85 85 85 85 85 85 85 85 85 86 127 84 305 305 305 305 305 305 305 305 305 305 305 305 305 305 305 305 305 305 305 305 305 305 305 305 305 305 305 305 305 305 305 305 305 305 305 305 305 305 305 305 305 305 305 305 305 305 305 305 86 127 84 85 86 187 203 203 203 203 204 305 305 84 85 85 305 
