305 23 321 321 321 321 321 321 321 321 321 321 321 321 321 38 39 51 143 143 51 321 321 51 155 155 51 38 39 321 321 321 321 321 321 321 321 321 0 1 2 3 4 28 19 18 20 19 20 19 20 19 20 16 20 16 17 20 39 40 41 38 39 40 21 305 305 305 305 305 305 305 305 305 305 305 305 305 305 305 305 305 305 305 305 305 305 305 305 305 305 305 305 305 305 305 305 305 305 305 305 305 305 305 305 305 305 305 305 305 305 305 305 86 169 226 305 305 305 99 99 99 99 76 105 105 105 105 106 305 
305 23 321 321 321 5 6 321 321 321 321 321 321 321 321 26 27 10 11 12 13 4 321 12 13 10 11 26 27 0 28 14 15 20 19 31 18 20 19 20 19 31 42 43 43 43 43 43 43 43 43 29 30 44 32 33 7 9 27 24 25 26 27 24 21 305 305 305 305 305 305 305 305 305 305 305 305 305 305 305 305 305 305 305 305 305 305 305 305 305 305 305 305 305 305 305 305 305 305 305 305 305 305 305 305 305 305 305 305 305 305 305 305 86 183 305 305 305 173 174 174 174 98 99 99 99 99 99 84 305 
305 23 19 20 19 20 19 20 31 20 19 16 17 18 19 40 41 38 39 40 41 20 18 40 41 38 39 51 41 42 43 43 43 29 30 44 32 43 43 29 30 44 32 33 34 43 43 43 29 47 48 44 44 44 44 48 21 23 41 38 7 63 63 63 64 305 305 305 305 305 305 305 305 305 305 305 305 305 305 305 305 305 305 305 305 305 305 305 305 305 305 305 305 305 305 305 305 305 305 305 305 305 305 305 305 305 305 305 305 305 305 305 305 104 105 105 72 305 187 203 203 203 174 175 305 305 305 305 84 305
305 23 43 43 33 34 29 30 44 32 43 43 43 43 43 24 25 26 27 7 63 63 63 63 9 26 27 10 25 43 43 29 48 44 44 44 44 48 47 44 44 44 44 48 48 46 48 47 44 44 44 44 44 bbb2783 58 63 64 23 25 26 35 36 36 36 22 305 305 305 305 305 305 305 305 305 305 305 305 305 305 305 305 305 305 305 305 305 305 305 305 305 305 305 305 305 305 305 305 305 305 305 305 305 305 305 305 305 305 305 305 305 305 305 305 85 85 85 86 305 102 203 203 203 203 204 305 305 305 305 84 305
305 23 48 46 48 46 44 44 44 44 48 47 48 48 7 9 39 40 41 21 22 22 22 22 23 40 41 38 39 47 46 318 58 63 63 61 320 44 44 bbb 58 63 63 61 bbb 44 44 44 44 44 44 bbb 57 bbb 22 22 22 23 39 40 305 305 126 128 21 305 305 305 305 305 305 305 305 305 305 305 305 305 305 305 305 305 305 305 305 305 305 305 305 305 305 305 305 305 305 305 305 305 305 305 305 305 305 305 305 305 305 305 305 305 305 305 305 84 99 99 100 305 173 203 203 203 203 204 305 305 305 305 84 305
305 62 63 63 63 63 63 63 63 63 63 63 63 63 64 62 63 63 63 64 22 22 22 22 62 9 155 155 155 155 7 317 22 22 22 22 316 63 63 317 22 22 22 22 62 9 155 155 155 155 7 22 22 22 22 22 22 62 63 63 63 63 9 127 21 305 305 305 305 305 305 305 305 305 305 305 305 305 305 305 305 305 305 305 305 305 305 305 305 305 305 305 305 305 305 305 305 305 305 305 305 305 305 305 305 305 305 305 305 305 305 305 305 86 129 126 305 305 187 203 102 203 203 102 305 305 103 135 84 305
305 22 22 22 22 22 22 22 22 22 22 22 22 22 22 22 22 22 22 22 22 22 22 22 22 22 82 82 82 82 22 22 22 22 22 22 22 22 22 22 22 22 22 22 22 22 82 82 82 82 22 22 22 22 22 22 22 22 22 22 22 22 23 127 21 305 305 305 305 305 305 305 305 305 305 305 305 305 305 305 305 305 305 305 305 305 305 305 305 305 305 305 305 305 305 305 305 305 305 305 305 305 305 305 305 305 305 305 305 305 305 305 305 86 127 70 71 72 187 203 174 203 203 175 305 305 84 149 84 305
305 305 305 305 305 305 305 305 305 305 305 305 305 305 305 305 305 305 305 305 305 305 305 305 305 305 305 305 305 305 305 305 305 85 85 85 85 85 85 85 85 85 85 85 85 85 85 85 85 85 85 85 85 85 85 85 85 85 85 85 85 85 86 127 84 305 305 305 305 305 305 305 305 305 305 305 305 305 305 305 305 305 305 305 305 305 305 305 305 305 305 305 305 305 305 305 305 305 305 305 305 305 305 305 305 305 305 305 305 305 305 305 305 86 127 84 85 86 187 203 203 203 203 204 305 305 84 85 85 305 